B




0000000000000
5555555555555
8888888888888
6666666666666
7777777777777
4444444444444
