D



4444444444444

1119999999999

5555555555555

9999999999111

7777777777777

6669999999999

3333333333333

9999999999333
